222222211113333333333000
222222211113333333333000
222222211113333333333000
222222211113333333333000
222222200000000000000000
222222200000000000000000
000000000000000000000000
000000000000000000000000
000000000000000000000000
000000000000000000000000
000000000000000000000000
000000000000000000000000
000000000000000000000000
111111111111111111111111
111111111111111111111111
111111111111111111111111
